#  #  ### # # # #  ##        #  #           ##  ##
 ####   ##  # ## # #  ## ## ##### ##########  ## #
 #  ##  #  # #    ###  #### #    #  # ##    #E #  
 #    ## #  #  ##    #         # ## ##    ### ####
### ## # ### ##  ### # # ####### #  ##    #    # #
 #    #   #  # #   ## # ##  #  # ## # ## #   #    
 # # ## ###  #####   ###   #  ###### #  ## ###  # 
 ##   ###  ###  # #### #   ###  ###  #  #  ## ####
#  # ####  # # #  # ######## ####   #   ## # # ###
## #  #  # # ## ## #   # #     #   ### ##    ## # 
###  #  ## ###  # ####  # ### ## #   #   ###   #  
    ##  ## #   # # #  #### # ### # # #  # ##  ####
 ##   ## ##  ## # ### # # ###  ## # ###### ## #  #
 # ##  #  #  # ##       #  #  #   ###   #  #  #  #
##   ## #### #  # ## ###  ## ###  #      #  #  ###
 ##  #   # ### ### # # # ## #   ## ### # # ## #  #
 ##  ####     # # ## #    #   #  #    # # #    # #
 #  # # ## ###    #   ###  ###  ####  ### # #    #
 ## #   ###  # # #  ##     ## ###  ### #   ### # #
     # #     # # # ###  # # ## ## #   #  ##    ## 
 # ## #####  # ###  ##### #   ## #####  ##  ## # #
### #  #  #####  ##        ##   ## ## ## ##  #  # 
 #   ## # # #     #  ## ## ##  #   ##  # #    ### 
 ## # ####  ##### ####  # #  ##  #    #  ### #  ##
 #   #    ## # ##  # #  ##    # #### #### #      #
 ## ## # # #  ### ### ##  ###   #   # # ##   ##   
##S # #  ##  #  #   #    # # # ## #####   # ##### 
 #    #     ##      # # #   ##  ## #     # ##  ## 
   ###### ##  #  ##  # # # #  ### #    #### #  #  
 ##  #  # #  #   ####     ###    ######  #  ##  # 
 #   ##    #  # #   #  # #  #   #  #  #   # # ### 
 ###   #  # ###     ###  ##   # ## #  ##  # ##    
  ###   ##     ### # # ### ## ### ##  ##  # #  # #
 #   ### # # # # # ##  ##  # # #   ## #  #   # # #
 #  #   # ## #  #  #  # # # #  ###   # #  #  ##  #
 #### ## # #  #  # # ## #  ## ## ##  ## #### #  # 
 #    ###  # ## # ## # # # #    #  ## # # #  ##  #
 ## ## # ##  ## # ### ###   # ####   ## # # # ## #
 #  #  ## # #   ###  ##   #  # #   ## #### #      
 #  ### # ## #### #  #  ## ### # # #       ### # #
 #     #    ##   #  ### ## # # ###     #  ####  # 
 # ## ## # ##   #  ## #   #  ##    #### #       ##
 ##    # ##  ###  ##   ## #####  ###     ## ####  
 ## #   #       ###  ##  # # ###  #  # ##  ##  ## 
 # ##  ## #### #  #### #         ##  #  # ##   # #
    ###  ##   #  ##   # ##### # #   ### # #  ## # 
 #     ##  ## ### #  ###     ##  #      ## #  ## #
##### # ##  ##  ##  # #### #    ## ## #   ##  #  #
  ##     #### ##   #  #  # ### #  #### #  #  ### #
 ## ####         #          #  ## #  # # ####   ##
#  #  ### # # # #  ##        #  #           ##  ##
 ####   ##  # ## # #  ## ## ##### ##########  ## #
 #  ##  #  # #    ###  #### #    #  # ##    #@ #  
 #    ## #  #  ##    #         # ## ##    ###@####
### ## # ### ##  ### # # ####### #  ##    #@@@ # #
 #    #   #  # #   ## # ##  #  # ## # ## #@@ #    
 # # ## ###  #####   ###   #  ###### #  ##@###  # 
 ##   ###  ###  # #### #   ###  ###  #  # @## ####
#  # ####  # # #  # ######## ####   #   ##@# # ###
## #  #  # # ## ## #   # #     #   ### ## @@@## # 
###  #  ## ###  # ####  # ### ## #   #   ###@@ #  
    ##  ## #   # # #  #### # ### # # #  # ## @####
 ##   ## ##  ## # ### # # ###  ## # ###### ##@#  #
 # ##  #  #  # ##       #  #  #   ###   #  # @#  #
##   ## #### #  # ## ###  ## ###  #      #  #@ ###
 ##  #   # ### ### # # # ## #   ## ### # # ##@#  #
 ##  ####     # # ## #    #   #  #    # # #  @@# #
 #  # # ## ###    #   ###  ###  ####  ### # # @  #
 ## #   ###  # # #  ##     ## ###  ### #   ###@# #
     # #     # # # ###  # # ## ## #   #  ##@@@@## 
 # ## #####  # ###  ##### #   ## #####  ## @## # #
### #  #  #####  ##        ##   ## ## ## ##@@#  # 
 #   ## # # #     #  ## ## ##  #   ##  # #  @ ### 
 ## # ####  ##### ####  # #  ##  #    #  ###@#@@##
 #   #    ## # ##  # #  ##    # #### #### # @@@@@#
 ## ## # # #  ### ### ##  ###   #   # # ##   ## @@
##S # #  ##  #  #   #    # # # ## #####   # #####@
 #@   #     ##      # # #   ##  ## #     # ##  ##@
@@@###### ##  #  ##  # # # #  ### #    #### #  # @
@##  #  # #  #   ####     ###    ######  #  ##  #@
@#   ##    #  # #   #  # #  #   #  #  #   # # ###@
@###   #  # ###     ###  ##   # ## #  ##  # ##  @@
@ ###   ##     ### # # ### ## ### ##  ##  # #  #@#
@#   ### # # # # # ##  ##  # # #   ## #  #   # #@#
@#  #   # ## #  #  #  # # # #  ###   # #  #  ##@@#
@#### ## # #  #  # # ## #  ## ## ##  ## #### # @# 
@#    ###  # ## # ## # # # #    #  ## # # #  ##@@#
@## ## # ##  ## # ### ###   # ####   ## # # # ##@#
@#  #  ## # #   ###  ##   #  # #   ## #### #  @@@ 
@#  ### # ## #### #  #  ## ### # # #@@@@@  ###@# #
@#     #    ##   #  ### ## # # ###@@@@@#@@####@ # 
@# ## ## # ##   #  ## #   #  ## @@@#### #@@@@@@ ##
@##    # ##  ###  ##   ## ##### @###     ## ####  
@## #   #       ###  ##  # # ###@ #  # ##  ##  ## 
@# ##  ## #### #  #### #       @@##  #  # ##   # #
@@@ ###  ##   #  ##   # ##### #@#   ### # #  ## # 
 #@@@@ ##  ## ### #  ###  @@@##@ #      ## #  ## #
#####@# ##  ##  ##  # ####@#@@@@## ## #   ##  #  #
  ## @@@@#### ##@@@#@@#@@#@### #  #### #  #  ### #
 ## ####@@@@@@@@@#@@@@@@@@@ #  ## #  # # ####   ##
