# ####  ##### #    ### #   # ## # #  #  ######### 
# # # ## # ## ### ##   ### ## ##   ##### # ##  ## 
#   ##   #       # # ### ### ## ####  #  #   #  # 
#  ## ###  ### ### ##   #   ##   ##  ####   ##   #
####### # #E## #### #     ######  ### # # # # ### 
#   #   # #   #   ##  ####   # #  #  ##  ###   ###
## #   # # ##  # ## ### # ## #   ## #####  #####  
#  # ## #  ### # ##     #  #  #### #   # # #   ###
 ##  ## ####   #   ##  # #        # # ## #  #    #
#   # # #  ## #### ### #  ### ### #  #  ##  ####  
 # ##   ### #    ##   #  # ### #####     #### ### 
# ### # #  # #  ##   #####   #  ## #  ####      ##
###    #  #### ### #  #  ### #       ####  #     #
#     #####    ## ### #  #    #  #  # # ## ### ## 
 ####   ### # # # ### #    # #  ###         ##  ##
##  ##       ## #  # ## ## ### # ## ## ###    #  #
 #  ## ## ## ## ### # ### # # #     ### ## ##### #
 ###    ### #     # #      # ### ##        # ## # 
   # #   #   # # # #### ##   ##### #    # # # ### 
 #  # ##    ## ###   # ## #### #  ## ###  ##  # # 
### # # ###  ###  ## # # # ###  #   ##  #   # #  #
 ##  ##    # ##  ###    #     ###  ##  ## ###  #  
  ## ### ###  # # # ###   ##   ### #  # #    # # #
##    #  #   # #### # # #########    #     #  # # 
 #  ##  ## # ## ## ###   ## ##   ####  # ##  #   #
  # #   ##  ### ###    ## ###  #     #### # ## ###
##  ####  #     # # #### ##  # ##  ## #    ##  # #
# #   # #  #  # #  #  #    # ### ## # # ###      #
#######  #   ####  ## ## #   ### #  ### # #  ###  
  # ##  #  ### ##  ## ##  ## ## # ##  ##  ## ## ##
## ##  ## # ## # #  # #  # #    # #    # #  ##   #
    ## ## # ##   ####  ## # ###    ## # ##### # ##
##         #  #### # ####  # ### #   # ###    ##  
 ### ## ## #  #       #  ##  ##  ##   #  # #  #  #
 ## #####  # #### # #    ## #    ####  # #####  ##
  #   # ## ###  #### ### #  ####### ##  #  #### # 
 # # #      #    ## # ## #   ##    # ##### ## ## #
# ### ## ##  #  # #   # #  ##   ##  ##  #### # # #
  ####  ### ## ##  ## #  ##   ##   #  # ## # # ###
##        #  # ## ####  ###  # ##  # #  ### #  #  
 #  ##   ## #   ##    ##   ## ##  ### ##  # ##  # 
 ## # # ###   # #     ##  ## # # #  # ##  ###  ###
 #   ### #  ### ## ### ### #  # ##   # # S   ### #
##  #  #  # ## # # # ##   # ##   #### # ### #    #
 ######   # # #    # ####  #  ###  #    # # ###  #
    # ###    ## # #  #  # ####       ##  #    ### 
 #####  # ####  ##### # # ##   # ## # ##  ## # # #
##### # #   ## ##    #### # ##  ##  # # #  #   #  
     ### ## # #  ## #       # #  #  ##  ##   #  ##
 ###  #  #            # ###     ## #  #   ## #### 
